حاجی قادری کۆیە - دیوان.PDF	5.8MB
سەید کامیل ئیمامی(ئاوات) - دیوانی شاری دڵ.pdf	5.7MB
شێخ ڕەزای تاڵەبانی - دیوان.PDF	5.6MB
شەریف حوسێن پەناهی - ملوانکەی شین.pdf	0.3MB
قانع - دیوان (کۆکردنەوەی بورهان قانع).pdf	5.6MB
مەحوی - دیوان.PDF	11.8MB
مەدهۆش - یانەی دڵان.pdf	1.7MB
مەلا ئەحمەدی قازی پێنجوێنی - دیوانی خەزنەی جەواهێر.pdf	3.9MB
مەلای جزیری - شەرحی هەژار - دیوان.PDF	12.5MB
ناری - دیوان.PDF	2.8MB
نالی - دیوان.pdf	60.2MB
هێمن - بارگەی یاران (کۆمەڵی شێعری هێمن).pdf	0.9MB
هێمن - توحفەی موزەفەرییە.pdf	5.0MB
هێمن - هەواری خاڵی (کۆمەڵی پەخشانی هێمن).pdf	1.1MB
هەردی - ڕازی تەنیایی.PDF	1.6MB
هەژار - بۆ کوردستان.pdf	1.9MB
هەژار - چوارینەکانی خەییام.pdf	0.3MB
وەلی دێوانە، ڕازی - دیوان - هەورامی و سۆرانی.pdf	2.2MB
پیرەمێرد - دیوانی پیرەمێرد - (محەمەد رەسول هاوار).pdf	3.9MB
چروستانی - دیوان.pdf	20.2MB
کوردی - دیوان، بەرگی دووەم.pdf	3.1MB
کوردی - دیوان، بەرگەی یەکەم.pdf	3.0MB
گۆران - دیوان.pdf	27.5MB